"광역시도","시군구","선거인수","투표수","이재명","윤석열","심상정","electionSum","electionRatio"
"서울특별시","종로구",129968,100629,46130,49172,3115,98417,97.8018265112443
"서울특별시","중구",111448,84998,38244,42906,2310,83460,98.1905456598979
"서울특별시","용산구",199077,152068,60063,85047,4374,149484,98.3007601862325
"서울특별시","성동구",252087,197240,84411,103880,5365,193656,98.1829243561144
"서울특별시","광진구",303582,235471,109922,113733,7072,230727,97.9853145397947
"서울특별시","동대문구",300928,232106,108171,112890,6416,227477,98.005652589765
"서울특별시","중랑구",347108,260862,130381,118201,6899,255481,97.9372235128152
"서울특별시","성북구",375880,292187,142702,135044,8952,286698,98.1214085500039
"서울특별시","강북구",268974,199448,103333,86540,5245,195118,97.8290080622518
"서울특별시","도봉구",281812,216036,106546,99780,5605,211931,98.0998537280824
"서울특별시","노원구",441879,349297,169275,163340,10021,342636,98.0930268510752
"서울특별시","은평구",417391,317971,161510,140666,9715,311891,98.0878759383717
"서울특별시","서대문구",269615,210460,100702,98924,6886,206512,98.1241090943647
"서울특별시","마포구",324091,256218,117916,124327,9308,251551,98.178504242481
"서울특별시","양천구",378710,301379,138586,149780,7821,296187,98.2772522305801
"서울특별시","강서구",504185,390247,190000,181510,11100,382610,98.0430342834154
"서울특별시","구로구",348156,272920,133027,127129,7539,267695,98.0855195661732
"서울특별시","금천구",208786,157035,80208,69227,4278,153713,97.8845480306938
"서울특별시","영등포구",334361,263581,116443,134846,7627,258916,98.2301455719494
"서울특별시","동작구",342248,271510,122914,135733,7866,266513,98.1595521343597
"서울특별시","관악구",446161,340773,169284,151944,11245,332473,97.564361026255
"서울특별시","서초구",344756,277878,88686,179472,5864,274022,98.6123406674872
"서울특별시","강남구",451970,354778,106865,235897,7020,349782,98.5917954326368
"서울특별시","송파구",565840,453536,180490,255166,10652,446308,98.4063007126226
"서울특별시","강동구",397634,313203,139172,160593,8029,307794,98.2730050478444
"부산광역시","중구",38032,27408,9929,16153,600,26682,97.3511383537653
"부산광역시","서구",94117,69786,25154,41470,1508,68132,97.6298971140343
"부산광역시","동구",80399,59326,21558,35081,1190,57829,97.4766544179618
"부산광역시","영도구",100073,71696,29565,39058,1368,69991,97.621903592948
"부산광역시","부산진구",313739,233474,89233,133285,5214,227732,97.5406255086219
"부산광역시","동래구",232079,179768,65261,106515,4035,175811,97.7988296025989
"부산광역시","남구",227098,173557,64361,101749,3652,169762,97.8133984800383
"부산광역시","북구",246904,189125,74650,105576,4262,184488,97.548182419035
"부산광역시","해운대구",339847,259616,92631,156792,5068,254491,98.0259306052015
"부산광역시","기장군",144027,106148,42955,58497,2253,103705,97.6984964389343
"부산광역시","사하구",268754,196600,78332,108983,4277,191592,97.4526958290946
"부산광역시","금정구",201647,155206,54772,93283,3500,151555,97.6476424880481
"부산광역시","강서구",112330,84488,36016,44889,1834,82739,97.9298835337563
"부산광역시","연제구",180732,139351,51471,81889,3087,136447,97.916053706109
"부산광역시","수영구",156367,118017,41801,71160,2617,115578,97.9333485853733
"부산광역시","사상구",185365,136658,54207,75692,3076,132975,97.3049510456761
"대구광역시","중구",65964,51325,10913,38288,981,50182,97.7730150998539
"대구광역시","동구",297312,232992,52170,171004,4522,227696,97.7269605823376
"대구광역시","서구",149729,113904,19516,89620,1818,110954,97.4100997331086
"대구광역시","남구",129711,97962,19765,73865,1784,95414,97.3989914456626
"대구광역시","북구",373173,294832,66469,215861,6090,288420,97.8252021490205
"대구광역시","수성구",349945,285537,59379,216031,5168,280578,98.2632723604997
"대구광역시","달서구",466792,368662,77951,275155,7361,360467,97.777096635943
"대구광역시","달성군",214088,166298,38882,120064,3407,162353,97.6277525887263
"인천광역시","중구",121916,90125,43942,41805,2296,88043,97.6898751733703
"인천광역시","동구",53909,40918,19195,19661,1196,40052,97.883572022093
"인천광역시","미추홀구",356862,253347,119287,121122,6951,247360,97.6368380126862
"인천광역시","연수구",317609,250104,111446,127768,6812,246026,98.3694782970284
"인천광역시","남동구",441525,329653,162476,150877,9232,322585,97.8559272932447
"인천광역시","부평구",424164,316024,159280,141072,8977,309329,97.8814900134167
"인천광역시","계양구",258741,193864,100532,83638,5502,189672,97.8376593900879
"인천광역시","서구",462821,346084,174908,154553,9594,339055,97.9689901873534
"인천광역시","강화군",63019,48473,17036,29267,988,47291,97.5615290986735
"인천광역시","옹진군",18659,14912,5218,8797,304,14319,96.0233369098712
"광주광역시","동구",90678,73877,60669,11036,1063,72768,98.4988562069386
"광주광역시","서구",248147,202633,170357,26262,2961,199580,98.493335241545
"광주광역시","남구",180643,148854,124572,19927,2073,146572,98.4669541967297
"광주광역시","북구",363088,295658,249976,36421,4550,290947,98.4066049286676
"광주광역시","광산구",326650,264470,224484,30865,4218,259567,98.1461035278103
"대전광역시","동구",192350,142804,65555,70069,3603,139227,97.4951682025714
"대전광역시","중구",199637,151200,66698,77459,3782,147939,97.843253968254
"대전광역시","서구",399599,304873,139877,150031,8427,298335,97.8555004870881
"대전광역시","유성구",288686,231027,108701,111342,6492,226535,98.0556385184416
"대전광역시","대덕구",152905,115404,54119,55159,3141,112419,97.4134345429968
"울산광역시","중구",182051,143171,54075,81399,3852,139326,97.314400262623
"울산광역시","남구",268213,209589,77783,121304,5251,204338,97.4946204237818
"울산광역시","동구",127599,98491,44506,47065,3427,94998,96.4534830593658
"울산광역시","북구",175732,138319,64692,64597,5072,134361,97.1384986878158
"울산광역시","울주군",188615,145891,56078,81956,3690,141724,97.1437580111179
"세종특별자치시","세종특별자치시",288895,231832,119349,101491,6780,227620,98.1831671210187
"경기도","수원시장안구",234723,183882,91842,83470,4755,180067,97.9252999206012
"경기도","수원시권선구",311536,235055,121028,103154,5754,229936,97.8222118227649
"경기도","수원시팔달구",161747,119627,58024,56051,3003,117078,97.8692101281483
"경기도","수원시영통구",295828,239154,114418,114252,6385,235055,98.2860416300794
"경기도","성남시수정구",207998,161006,86224,68806,3128,158158,98.231121821547
"경기도","성남시중원구",186278,142368,80857,56072,2799,139728,98.1456507080243
"경기도","성남시분당구",404493,335434,140966,183094,7005,331065,98.6975083026765
"경기도","의정부시",398960,295029,154851,127348,6788,288987,97.9520657291317
"경기도","안양시만안구",209083,162812,82650,73147,3901,159698,98.0873645677223
"경기도","안양시동안구",262895,216629,105221,102552,5574,213347,98.484967386638
"경기도","부천시",699678,532995,285227,224331,13249,522807,98.0885374159232
"경기도","광명시",247357,198669,103470,87112,4746,195328,98.3183083420161
"경기도","평택시",472732,338768,166032,156630,7988,330650,97.6036697681009
"경기도","양주시",197345,145562,75236,63800,3162,142198,97.6889572828073
"경기도","동두천시",81075,57532,28495,26434,1125,56054,97.4309949245637
"경기도","안산시상록구",303413,222254,121488,90654,5103,217245,97.7462722830635
"경기도","안산시단원구",260659,192948,103595,80605,4563,188763,97.8310218297158
"경기도","고양시덕양구",414210,323033,167037,139914,10643,317594,98.3162710930462
"경기도","고양시일산동구",256654,197004,96990,91849,5032,193871,98.4096769608739
"경기도","고양시일산서구",251203,197311,99597,89677,4975,194249,98.448135177461
"경기도","과천시",63841,54194,21072,30934,1314,53320,98.387275344134
"경기도","의왕시",139712,113105,54997,53556,2717,111270,98.377613721763
"경기도","구리시",164281,127688,63465,58865,3023,125353,98.171323851889
"경기도","남양주시",608146,460518,239179,203075,10089,452343,98.2248250882702
"경기도","오산시",188297,135108,72877,55793,3352,132022,97.7159013529917
"경기도","화성시",703896,542027,283324,236055,12955,532334,98.2117127006588
"경기도","시흥시",424723,317197,178462,125544,7082,311088,98.0740675353172
"경기도","군포시",229884,183089,94891,80277,4593,179761,98.182304780735
"경기도","하남시",265087,208858,101106,100088,4624,205818,98.5444656177882
"경기도","파주시",401260,297278,157155,126763,7176,291094,97.9197922483332
"경기도","여주시",98077,72566,30695,38731,1458,70884,97.6821100791004
"경기도","이천시",187895,137512,63562,67726,2995,134283,97.6518412938507
"경기도","용인시처인구",220689,162420,80188,75105,3618,158911,97.8395517793375
"경기도","용인시수지구",304545,250764,113161,128995,5334,247490,98.6943899443301
"경기도","용인시기흥구",361753,289459,143279,135606,6267,285152,98.5120517931728
"경기도","안성시",162452,117380,56723,54799,2892,114414,97.4731640824672
"경기도","김포시",391889,302170,153206,136814,6905,296925,98.2642221266175
"경기도","포천시",131901,95968,44320,47306,1903,93529,97.4585278426142
"경기도","연천군",37817,28904,12013,15325,604,27942,96.6717409355107
"경기도","양평군",106406,83065,34324,45487,1662,81473,98.0834286402215
"경기도","가평군",55618,42512,16684,23870,872,41426,97.445427173504
"강원도","춘천시",243403,186646,82376,94926,5294,182596,97.8301169058003
"강원도","원주시",302881,226239,100954,113560,6105,220619,97.5159013255893
"강원도","강릉시",185823,141724,54377,80482,3434,138293,97.5790974005814
"강원도","동해시",77147,57515,22896,31739,1359,55994,97.3554724854386
"강원도","삼척시",56233,43642,16297,25308,897,42502,97.3878374043353
"강원도","태백시",35551,27039,10846,15101,489,26436,97.7698879396427
"강원도","정선군",32101,24898,10103,13643,494,24240,97.3572174471845
"강원도","속초시",71571,52516,21713,28342,1230,51285,97.6559524716277
"강원도","고성군",24668,19218,7433,10840,427,18700,97.3046102612134
"강원도","양양군",25257,19716,7343,11495,434,19272,97.7480219111382
"강원도","인제군",27897,21836,8937,11591,501,21029,96.3042681809855
"강원도","홍천군",60872,46697,18418,25851,1049,45318,97.0469195023235
"강원도","횡성군",41685,32625,12557,18546,676,31779,97.4068965517241
"강원도","영월군",34306,26925,10758,14904,536,26198,97.2999071494893
"강원도","평창군",37325,29353,11463,16571,564,28598,97.4278608660103
"강원도","화천군",21088,16494,6445,9009,433,15887,96.319873893537
"강원도","양구군",18565,14529,5689,7878,387,13954,96.0423979626953
"강원도","철원군",37248,27846,11039,15194,722,26955,96.8002585649645
"충청북도","청주시상당구",162949,122198,55852,59685,3548,119085,97.4524951308532
"충청북도","청주시서원구",165206,124726,56323,61745,3499,121567,97.4672482080721
"충청북도","청주시흥덕구",223335,163683,76940,77952,4770,159662,97.5434223468534
"충청북도","청주시청원구",159671,117836,56679,54855,3331,114865,97.4786992090702
"충청북도","충주시",180976,135848,58801,70382,3270,132453,97.5008833402038
"충청북도","제천시",114317,87091,36442,46482,1922,84846,97.4222365112354
"충청북도","단양군",25748,20193,7271,11969,387,19627,97.1970484821473
"충청북도","영동군",41165,31795,12029,18238,664,30931,97.2825916024532
"충청북도","보은군",28971,22717,8757,12754,525,22036,97.0022450147467
"충청북도","옥천군",44671,34242,14138,18241,864,33243,97.0825302260382
"충청북도","진천군",71306,51932,25402,23759,1361,50522,97.2849110375106
"충청북도","괴산군",34819,27419,10304,15895,546,26745,97.5418505415952
"충청북도","증평군",30953,22653,10215,11264,560,22039,97.289542223988
"충청남도","천안시서북구",329610,238154,115553,110141,6568,232262,97.5259705904583
"충청남도","천안시동남구",216193,157433,71851,77739,4085,153675,97.6129528116723
"충청남도","공주시",91684,68872,28472,37339,1423,67234,97.6216749912882
"충청남도","보령시",86253,65715,26207,36419,1367,63993,97.3795937000685
"충청남도","아산시",265136,192927,93262,89998,4976,188236,97.568510369207
"충청남도","서산시",148201,108990,48642,54892,2640,106174,97.4162767226351
"충청남도","태안군",55320,42028,16678,23511,873,41062,97.7015323117921
"충청남도","금산군",44799,33699,14002,18178,647,32827,97.4123861242173
"충청남도","논산시",100285,73512,33822,36203,1601,71626,97.4344324736098
"충청남도","계룡시",34745,27992,11891,14718,799,27408,97.9136896256073
"충청남도","당진시",139481,100874,46903,49230,2258,98391,97.5385133929457
"충청남도","부여군",57573,43975,16813,25136,878,42827,97.3894258101194
"충청남도","서천군",45997,35136,15443,18168,688,34299,97.6178278688525
"충청남도","홍성군",84379,62416,25860,33581,1536,60977,97.6945014098949
"충청남도","청양군",27754,21588,7688,12932,416,21036,97.4430239021679
"충청남도","예산군",69064,51349,16904,32098,1034,50036,97.4429881789324
"전라북도","전주시완산구",285828,231447,188693,35152,3907,227752,98.4035221886652
"전라북도","전주시덕진구",265049,215995,175845,32731,4006,212582,98.4198708303433
"전라북도","군산시",225149,177339,144395,27400,2613,174408,98.3472332651024
"전라북도","익산시",239340,189310,154719,28076,3074,185869,98.1823464159315
"전라북도","정읍시",93594,75092,63487,9085,1040,73612,98.0290843232302
"전라북도","남원시",69190,56509,47470,7163,731,55364,97.9737740890832
"전라북도","김제시",72285,58026,48952,7164,750,56866,98.0008961500017
"전라북도","완주군",78117,63481,52862,8443,1063,62368,98.2467194908713
"전라북도","진안군",22568,18855,15637,2572,264,18473,97.9740121983559
"전라북도","무주군",21244,17429,13292,3426,313,17031,97.7164495955018
"전라북도","장수군",19371,16230,13564,2063,222,15849,97.6524953789279
"전라북도","임실군",24186,20057,16930,2416,253,19599,97.7165079523358
"전라북도","순창군",23847,19879,16980,2211,230,19421,97.696061170079
"전라북도","고창군",47655,38707,33000,4335,518,37853,97.7936807295838
"전라북도","부안군",45702,36856,31037,4572,467,36076,97.8836553071413
"전라남도","목포시",183659,145187,125790,14936,2021,142747,98.3194087624925
"전라남도","여수시",237455,189617,162006,21986,2266,186258,98.2285343613705
"전라남도","순천시",235327,192412,162566,23709,2780,189055,98.255306321851
"전라남도","나주시",99117,81076,68994,9512,1019,79525,98.0869801174207
"전라남도","광양시",126644,100876,81441,15843,1560,98844,97.9856457432888
"전라남도","담양군",41698,34632,30076,3435,396,33907,97.9065604065604
"전라남도","장성군",38486,31666,27132,3566,386,31084,98.1620665698225
"전라남도","곡성군",25143,20717,17472,2380,305,20157,97.2969059226722
"전라남도","구례군",22770,19132,16137,2352,232,18721,97.8517666736358
"전라남도","고흥군",57414,47171,40466,5120,507,46093,97.7146975896207
"전라남도","보성군",35850,29323,25214,3102,322,28638,97.6639498004979
"전라남도","화순군",55122,45152,39327,4389,475,44191,97.8716335931963
"전라남도","장흥군",32712,27048,23565,2555,301,26421,97.6818988464951
"전라남도","강진군",30272,24960,21064,3010,298,24372,97.6442307692308
"전라남도","완도군",42767,35300,31062,3085,347,34494,97.7167138810198
"전라남도","해남군",59631,48441,42071,4690,510,47271,97.5846906546108
"전라남도","진도군",26802,21744,18692,2313,219,21224,97.6085356880059
"전라남도","영암군",46507,37333,31909,4092,521,36522,97.8276591755284
"전라남도","무안군",75012,61552,52983,6624,808,60415,98.1527813880946
"전라남도","영광군",45280,36321,30855,4056,475,35386,97.4257316703835
"전라남도","함평군",28435,23295,20467,2052,259,22778,97.7806396222365
"전라남도","신안군",35175,29213,25583,2742,272,28597,97.8913497415534
"경상북도","포항시북구",232070,183046,45053,130458,3911,179422,98.0201697933853
"경상북도","포항시남구",197466,152184,38517,106712,3250,148479,97.5654470903643
"경상북도","울릉군",8141,6653,1590,4815,109,6514,97.9107169697881
"경상북도","경주시",220573,173759,43031,123196,3380,169607,97.6104834857475
"경상북도","김천시",120746,95575,22122,69272,1838,93232,97.5485221030604
"경상북도","안동시",136307,106950,30870,71881,1674,104425,97.6390836839645
"경상북도","구미시",338810,253211,67054,173950,5537,246541,97.3658332378925
"경상북도","영주시",89380,70769,17937,50214,1153,69304,97.9298845539714
"경상북도","영천시",91044,70942,14332,53537,1119,68988,97.2456372811593
"경상북도","상주시",85100,68459,13660,51935,1097,66692,97.4188930600798
"경상북도","문경시",63035,49720,9912,37738,808,48458,97.461786001609
"경상북도","예천군",47677,39128,9147,28320,653,38120,97.4238397055817
"경상북도","경산시",230797,176406,40267,128158,3533,171958,97.4785438137025
"경상북도","청도군",38816,30953,5654,24036,489,30179,97.4994346266921
"경상북도","고령군",27955,22270,3852,17464,317,21633,97.139649753031
"경상북도","성주군",39491,32009,5775,24975,472,31222,97.541316504733
"경상북도","칠곡군",96181,71492,17603,50468,1369,69440,97.1297487830806
"경상북도","군위군",21784,18239,2511,15032,216,17759,97.3682767695597
"경상북도","의성군",47369,39245,6431,31176,545,38152,97.2149318384508
"경상북도","청송군",22793,18789,3716,14268,298,18282,97.301612645697
"경상북도","영양군",14932,12337,2855,8968,208,12031,97.5196563183918
"경상북도","영덕군",32227,25897,4342,20611,310,25263,97.551839981465
"경상북도","봉화군",28052,22707,5252,16451,361,22064,97.1682741004976
"경상북도","울진군",42282,33544,6888,25287,476,32651,97.3378249463391
"경상남도","창원시의창구",185646,143063,52289,82914,3805,139008,97.1655843928899
"경상남도","창원시성산구",213187,170073,67177,93082,5428,165687,97.4211074068194
"경상남도","창원시마산합포구",156984,120928,37657,77518,2618,117793,97.4075482931993
"경상남도","창원시마산회원구",160587,125233,41527,77282,2911,121720,97.194828839044
"경상남도","창원시진해구",159611,119212,45890,66298,3075,115263,96.687414018723
"경상남도","진주시",292842,228238,74975,141433,5578,221986,97.26075412508
"경상남도","통영시",106361,80080,26387,49772,1573,77732,97.0679320679321
"경상남도","고성군",45053,34327,10348,22213,645,33206,96.73434905468
"경상남도","사천시",94303,71772,23424,44656,1581,69661,97.0587415705289
"경상남도","김해시",444342,328521,150338,160401,8587,319326,97.201092167624
"경상남도","밀양시",92517,70249,21906,44881,1457,68244,97.1458668450796
"경상남도","거제시",194074,145481,64355,71772,4186,140313,96.4476460843684
"경상남도","의령군",24419,19089,5396,12625,349,18370,96.2334328670962
"경상남도","함안군",54570,41791,13504,26066,921,40491,96.889282381374
"경상남도","창녕군",54037,41401,10934,28492,716,40142,96.9590106519166
"경상남도","양산시",294133,220501,92137,116904,5364,214405,97.2353866875887
"경상남도","하동군",39640,32089,11218,18974,723,30915,96.3414254105768
"경상남도","남해군",38680,30297,10143,18503,676,29322,96.7818595900584
"경상남도","함양군",34459,26955,8526,16957,528,26011,96.4978668150621
"경상남도","산청군",31645,24913,7125,16607,464,24196,97.1219845060812
"경상남도","거창군",53049,41399,11963,27254,895,40112,96.8912292567453
"경상남도","합천군",39768,31270,6911,22742,511,30164,96.4630636392709
"제주특별자치도","제주시",408552,296826,157695,122084,10007,289786,97.6282401137367
"제주특별자치도","서귀포시",155802,112823,55435,50930,3591,109956,97.4588514753197
